NO ../wall-north.xpm
SO ../wall-south.xpm
WE ../wall-west.xpm
EA ../wall-east.xpm

F 255,150,50
C 50,150,255

111111111111111111111111
100000000000000000000001
101111110000001111110001
100001110000011100010001
101001100000000000011001
101101000001111111111001
100000000000000000000001
100000001000000000001101
101010001100111110001101
1010100N0110001110001001
101010100011001100011001
101010110001101000110001
100000110000100000100001
100000111100111111100001
101100000000010000000001
101100110011000000000001
101101110001001111111001
101101111100000111111001
101100000000100110000001
101100000000100110000001
101101111100100000000001
101100000000100001111101
100000000000000000000001
111111111111111111111111